MAP 18,10
BEGIN 1
0,0,0,0,0,0,0,0,0,0,0,0,0,0,0,0,0,0,
0,0,0,0,0,0,0,0,0,0,0,2,0,0,0,0,0,0,
0,0,0,0,0,0,0,0,3,3,3,3,3,3,3,3,3,0,
0,0,0,0,2,0,3,3,3,0,0,0,0,0,0,0,3,0,
0,0,0,0,0,3,3,0,0,0,0,0,0,2,0,0,0,0,
0,0,0,0,0,0,2,2,0,0,0,0,0,0,2,0,0,0,
2,0,0,0,0,0,2,2,2,0,0,0,0,0,0,0,2,2,
0,0,0,0,0,2,2,2,0,0,0,0,0,0,0,0,0,0,
0,0,0,0,0,0,0,0,0,0,0,0,0,2,0,0,0,0,
0,0,0,0,0,0,0,0,0,0,0,2,0,0,0,0,0,0,
END
BEGIN 1
5,5,5,5,5,5,1,1,1,1,1,1,1,1,1,1,1,5,
5,1,1,1,1,1,1,5,5,5,5,5,5,5,5,5,5,5,
1,1,5,5,5,5,5,5,5,5,5,5,5,5,5,5,5,1,
5,1,5,5,5,5,5,5,5,5,1,1,1,5,5,5,5,5,
5,1,1,5,5,5,5,5,5,5,1,1,1,5,5,5,5,5,
5,5,1,5,5,5,5,5,5,5,1,1,1,1,5,5,5,5,
5,5,1,5,5,5,5,5,5,5,1,1,1,1,1,1,5,5,
5,5,1,5,5,5,5,5,5,5,5,5,1,1,1,1,5,5,
5,1,1,5,5,1,5,5,5,5,1,1,1,5,5,5,5,5,
5,1,1,1,1,1,1,5,5,5,5,5,5,5,5,5,5,5,
END
BEGIN 1
1,5,5,5,5,5,5,5,5,5,5,5,5,5,5,5,5,5,
5,5,5,5,5,5,5,5,5,5,5,5,5,5,5,5,5,5,
5,5,5,5,5,5,5,5,5,5,5,5,5,5,5,5,5,5,
5,5,5,5,5,5,5,5,5,5,5,5,5,5,5,5,5,5,
5,5,5,5,5,5,5,5,5,5,5,5,5,5,5,5,5,5,
5,5,5,5,5,5,5,5,5,5,5,5,5,5,5,5,5,5,
5,5,5,5,5,5,5,5,5,5,5,5,5,5,5,5,5,5,
5,5,5,5,5,5,5,5,5,5,5,5,5,5,5,5,5,5,
5,5,5,5,5,5,5,5,5,5,5,5,5,5,5,5,5,5,
5,5,5,5,5,5,5,5,5,5,5,5,5,5,5,5,1,5,
END